10
20
11111111111111111111
10000000000000000001
10500202000000200001
10002220000002200001
10000000000200000001
10200000000002202001
10022202002200220001
10200000000020000201
10000000000000000001
11111111111111111111
