15
30
111111111111111111111111111111
150011112011111111100201111211
110002110011000000000005111001
110000000001020001111100111101
111000011100111111111100111101
121110001150000000021110111101
100111110001111111101110011001
100001020011011111101112011011
105100011100000000000110010011
100111011100200111110000000111
100111001100000100010000001111
110111102111111001011000011111
110211111111111011001111000011
111000000000000510000021100201
111111111111111111111111111111
