15
30
111111111111111111111111111111
150011120011100000100200001211
110002110011001110000000111001
120100000001120011111101111101
111111011101111111111100120001
121112001100000000021110111101
100111111001111111101000011001
110001020011211111101112011011
100100011110000000000110010011
101111011100200111110000000111
100101001100001100010000001111
110101102111111001011000011111
110201111111111011001111000011
111000000000000010000021100201
111111111111111111111111111111
