15
30
111111111111111111111111111111
150011112011111111100001111211
110000110011000000000000111001
110000111001020001111100111101
111000011100111111111100111101
121110001110000000021110111101
100111000111111111101110011001
100001100000011111101112011011
100100010000000000000110010011
100111011100200000000000000111
100111001100000000000000001111
110111102111111001111000011111
110011111111111011111111000011
111000000000000011111111100251
111111111111111111111111111111
