15
30
111111111111111111111111111111
150010021011100000100210001211
110002111011001110001000111001
120100000001120010110101011101
111111011101111111111100120001
121112001100000000021110111101
100111111001111111101000011001
110001020011211111101112011011
100100011110000000000100010011
101111011000200111110001000111
100101001100001100010011001111
110101102111011001011001011111
100201111101111011001111001011
101000000000000010000021100251
111111111111111111111111111111
